Code => Location
hnf7 => All YV DTT Regions
hnvg => Liverpool
hnvj => Manchester
hnvm => Preston
hncr => Oxfordshire & Buckinghamshire
hnct => East Yorkshire & Lincolnshire
hncs => South East
hncw => North East
hncv => Kent
hncy => Yorkshire
hncx => South Yorkshire
hnc2 => Gloucestershire
hncz => United Kingdom
hnc5 => London
hnc4 => Wales
hnc7 => Isle of Man
hnc6 => South West
hnc9 => West Midlands
hndc => England
hndb => South
hndf => Cambridgeshire & Bedfordshire
hndd => Channel Islands
hndg => Borders
hndk => East Midlands
hndj => Berkshire & North Hampshire
hndn => Ireland
hndm => Central Scotland
hndq => East Anglia
hnds => East Borders
hndr => Scotland
hndv => West
hndt => South Lakes
hndx => North Scotland
hndw => Belfast
hndz => Northern Ireland
hndy => West Borders
hnd2 => North West
hnd8 => Salisbury
hnfb => London Central
hnd9 => Newcastle
hnfd => Leeds
hnfc => Southampton
hnfg => Middlesbrough
hnff => Reading
hnfj => Guildford
hnfh => Maidstone & Tonbridge
hnfm => Gloucester Central
hnfk => Basingstoke
hnfn => Birmingham
hnfq => Gloucester West
hnft => York
hnfs => Cambridge
